NO ./texture/brick.xpm
SO ./texture/brick.xpm
WE ./texture/brick.xpm
EA ./texture/brick.xpm

F 220,100,15
C 255,255,255


   11111      
11111111
10000N11111111
100011110000011
10001  10000001
100011110000011
10000000000001
10001111100001
11111   111111
              