NO ./path_to_the_north_texture
SO ./path_to_the_south_texture
WE ./path_to_the_west_texture
EA ./path_to_the_east_texture

F 220,100,15
C 255,255,255
11111111111111
10000000000001
10000000000001
10000000000001
10000000000001
100000N0000001
10000000000001
10000000000001
10000000000001
10000000000001
10000000000001
10000000000001
10000000000001
10000000000001
10000000000001
11111111111111