F 220,100,15
C 255,255,255

NO ./texture/5555.xpm
SO ./texture/eagle.xpm
WE ./texture/hitler.xpm
EA ./texture/eagle.xpm

   111111      
11111111         
1N11001111111111111111111111111111
100010000000000001000000000000011
100000000000000000000000000000011
100000000000000000000000000000011
100000000000000000000000000000011
100000000000000000000000000000011
100000000000000000000000000000011
100000000000000000000000000000011
100000000000000000000000000000011
111111000000000000000000000000011
111111000000000000000000000000011
111111000000000000000000000000011
111111000000000000000000000000011
100000000000000000000000000000011
100000000000000000000000000000011
100000000000000000000000000000011
100000000000000000000000000000011
100000000000000000000000000000011
100000000000000000000000000000011
100000000000000000000000000000011
100000000000000000000000000000011
100000000000000000000000000000011
110000000000000000000000000000111
111111111111111111111111111111111
111111111111111111111111111111111
100000000000000000000000000000111
100000000000000000000000000000011
100000000000000000000000000000011
111111111111111111111111111111111
