NO ./path_to_the_north_texture
SO ./path_to_the_south_texture
WE ./path_to_the_west_texture
EA ./path_to_the_east_texture

F 220,100,15
C 255,255,255
11111111111111111111
      11111111111111
      11111111111111
11111110000001
10000001000001
10000011111101
100000000N0001
10001111111101
10000011100001
11111111111111