NO ./texture/brick.xpm
SO ./texture/chest.xpm
WE ./texture/hitler.xpm
EA ./texture/wood.xpm

F 220,100,15
C 255,255,255


   11111      
11111111
100000111111111111111111111111111
10000000000000S000000000000000011
100000000000000000000000000000011
100000000000000000000000000000011
100000000000000000000000000000011
100000000000000000000000000000011
100000000000000000000000000000011
100000000000000000000000000000011
100000000000000000000000000000011
100000000000000000000000000000011
100000000000000000000000000000011
100000000000000000000000000000011
100000000000000000000000000000011
100000000000000000000000000000011
1000000000000000000000000000000111
100000000000000000000000000000011
100000000000000000000000000000011
100000000000000000000000000000011
100000000000000000000000000000011
100000000000000000000000000000011
100000000000000000000000000000011
100000000000000000000000000000011
100000000000000000000000000000011
100000000000000000000000000000011
111111111111111111111111111111111